"filename", "language", "C#", "ShaderLab", "HLSL", "comment", "blank", "total"
"d:\TLProject\unity\Ongoing\Evolution\Assets\Scripts\Common\GenNoise.cs", "C#", 55, 0, 0, 0, 8, 63
"d:\TLProject\unity\Ongoing\Evolution\Assets\Scripts\Common\RenderTextureUtils.cs", "C#", 15, 0, 0, 0, 1, 16
"d:\TLProject\unity\Ongoing\Evolution\Assets\Scripts\Data\ColorTexturePreset.cs", "C#", 38, 0, 0, 0, 4, 42
"d:\TLProject\unity\Ongoing\Evolution\Assets\Scripts\Data\SpeciesUiPreset.cs", "C#", 51, 0, 0, 0, 6, 57
"d:\TLProject\unity\Ongoing\Evolution\Assets\Scripts\Debuger.cs", "C#", 16, 0, 0, 0, 3, 19
"d:\TLProject\unity\Ongoing\Evolution\Assets\Scripts\EvoLayers\EvoBasicElements.cs", "C#", 36, 0, 0, 0, 6, 42
"d:\TLProject\unity\Ongoing\Evolution\Assets\Scripts\EvoLayers\EvoBrush.cs", "C#", 70, 0, 0, 12, 11, 93
"d:\TLProject\unity\Ongoing\Evolution\Assets\Scripts\EvoLayers\EvoLiquid.cs", "C#", 11, 0, 0, 0, 3, 14
"d:\TLProject\unity\Ongoing\Evolution\Assets\Scripts\EvoLayers\EvoNoiseGenerator.cs", "C#", 10, 0, 0, 2, 1, 13
"d:\TLProject\unity\Ongoing\Evolution\Assets\Scripts\EvoLayers\EvoTempSim.cs", "C#", 4, 0, 0, 0, 2, 6
"d:\TLProject\unity\Ongoing\Evolution\Assets\Scripts\EvoLayers\IEvoluteLayer.cs", "C#", 7, 0, 0, 0, 3, 10
"d:\TLProject\unity\Ongoing\Evolution\Assets\Scripts\EvoLayers\MonoEvoLayer.cs", "C#", 36, 0, 0, 0, 5, 41
"d:\TLProject\unity\Ongoing\Evolution\Assets\Scripts\MainMap.cs", "C#", 46, 0, 0, 0, 6, 52
"d:\TLProject\unity\Ongoing\Evolution\Assets\Scripts\Shader\ComputeShader\Elements\Brush.compute", "HLSL", 0, 0, 45, 0, 5, 50
"d:\TLProject\unity\Ongoing\Evolution\Assets\Scripts\Shader\ComputeShader\Elements\Fire.compute", "HLSL", 0, 0, 161, 22, 23, 206
"d:\TLProject\unity\Ongoing\Evolution\Assets\Scripts\Shader\ComputeShader\Elements\Flower.compute", "HLSL", 0, 0, 124, 0, 20, 144
"d:\TLProject\unity\Ongoing\Evolution\Assets\Scripts\Shader\ComputeShader\Elements\Gas.compute", "HLSL", 0, 0, 63, 5, 13, 81
"d:\TLProject\unity\Ongoing\Evolution\Assets\Scripts\Shader\ComputeShader\Elements\Gravity.compute", "HLSL", 0, 0, 74, 0, 10, 84
"d:\TLProject\unity\Ongoing\Evolution\Assets\Scripts\Shader\ComputeShader\Elements\Liquid.compute", "HLSL", 0, 0, 143, 26, 21, 190
"d:\TLProject\unity\Ongoing\Evolution\Assets\Scripts\Shader\ComputeShader\Elements\Magma.compute", "HLSL", 0, 0, 63, 0, 12, 75
"d:\TLProject\unity\Ongoing\Evolution\Assets\Scripts\Shader\ComputeShader\Elements\Soild.compute", "HLSL", 0, 0, 62, 2, 11, 75
"d:\TLProject\unity\Ongoing\Evolution\Assets\Scripts\Shader\ComputeShader\Elements\Template.compute", "HLSL", 0, 0, 39, 2, 9, 50
"d:\TLProject\unity\Ongoing\Evolution\Assets\Scripts\Shader\ComputeShader\Elements\Water.compute", "HLSL", 0, 0, 94, 0, 16, 110
"d:\TLProject\unity\Ongoing\Evolution\Assets\Scripts\Shader\ComputeShader\GenNoise.compute", "HLSL", 0, 0, 156, 5, 31, 192
"d:\TLProject\unity\Ongoing\Evolution\Assets\Scripts\Shader\ComputeShader\Temprature.compute", "HLSL", 0, 0, 57, 0, 10, 67
"d:\TLProject\unity\Ongoing\Evolution\Assets\Scripts\Shader\ComputeShader\Utils.hlsl", "HLSL", 0, 0, 103, 0, 21, 124
"d:\TLProject\unity\Ongoing\Evolution\Assets\Scripts\Shader\MainMap.shader", "ShaderLab", 0, 60, 0, 0, 6, 66
"d:\TLProject\unity\Ongoing\Evolution\Assets\Scripts\Shader\MapShader.shader", "ShaderLab", 0, 93, 0, 0, 14, 107
"d:\TLProject\unity\Ongoing\Evolution\Assets\Scripts\Shader\Temperature.shader", "ShaderLab", 0, 50, 0, 0, 6, 56
"d:\TLProject\unity\Ongoing\Evolution\Assets\Scripts\Species.cs", "C#", 31, 0, 0, 6, 7, 44
"d:\TLProject\unity\Ongoing\Evolution\Assets\Scripts\View\Binder\LeftSidePanel.cs", "C#", 63, 0, 0, 0, 12, 75
"d:\TLProject\unity\Ongoing\Evolution\Assets\Scripts\View\Displayer.cs", "C#", 44, 0, 0, 0, 8, 52
"d:\TLProject\unity\Ongoing\Evolution\Assets\Scripts\View\UiItem.cs", "C#", 26, 0, 0, 0, 4, 30
"Total", "-", 559, 203, 1184, 82, 318, 2346