"filename", "language", "C#", "ShaderLab", "HLSL", "comment", "blank", "total"
"d:\TLProject\unity\Ongoing\Evolution\Assets\Scripts\Binder\BrushBinder.cs", "C#", 35, 0, 0, 0, 7, 42
"d:\TLProject\unity\Ongoing\Evolution\Assets\Scripts\ComputeShader\Brush.compute", "HLSL", 0, 0, 21, 0, 4, 25
"d:\TLProject\unity\Ongoing\Evolution\Assets\Scripts\ComputeShader\Fire.compute", "HLSL", 0, 0, 81, 1, 13, 95
"d:\TLProject\unity\Ongoing\Evolution\Assets\Scripts\ComputeShader\Gas.compute", "HLSL", 0, 0, 53, 14, 13, 80
"d:\TLProject\unity\Ongoing\Evolution\Assets\Scripts\ComputeShader\GenNoise.compute", "HLSL", 0, 0, 156, 5, 31, 192
"d:\TLProject\unity\Ongoing\Evolution\Assets\Scripts\ComputeShader\Liquid.compute", "HLSL", 0, 0, 112, 1, 19, 132
"d:\TLProject\unity\Ongoing\Evolution\Assets\Scripts\ComputeShader\Soild.compute", "HLSL", 0, 0, 81, 3, 13, 97
"d:\TLProject\unity\Ongoing\Evolution\Assets\Scripts\ComputeShader\Template.compute", "HLSL", 0, 0, 39, 2, 9, 50
"d:\TLProject\unity\Ongoing\Evolution\Assets\Scripts\ComputeShader\Temprature.compute", "HLSL", 0, 0, 49, 0, 10, 59
"d:\TLProject\unity\Ongoing\Evolution\Assets\Scripts\ComputeShader\Utils.hlsl", "HLSL", 0, 0, 107, 0, 19, 126
"d:\TLProject\unity\Ongoing\Evolution\Assets\Scripts\Data\ColorTexturePreset.cs", "C#", 37, 0, 0, 0, 4, 41
"d:\TLProject\unity\Ongoing\Evolution\Assets\Scripts\EvoLayers\EvoBasicElements.cs", "C#", 3, 0, 0, 0, 2, 5
"d:\TLProject\unity\Ongoing\Evolution\Assets\Scripts\EvoLayers\EvoBrush.cs", "C#", 67, 0, 0, 12, 11, 90
"d:\TLProject\unity\Ongoing\Evolution\Assets\Scripts\EvoLayers\EvoNoiseGenerator.cs", "C#", 10, 0, 0, 2, 1, 13
"d:\TLProject\unity\Ongoing\Evolution\Assets\Scripts\EvoLayers\EvoTempSim.cs", "C#", 8, 0, 0, 0, 2, 10
"d:\TLProject\unity\Ongoing\Evolution\Assets\Scripts\EvoLayers\EvoluteLayer.cs", "C#", 39, 0, 0, 0, 5, 44
"d:\TLProject\unity\Ongoing\Evolution\Assets\Scripts\GenNoise.cs", "C#", 55, 0, 0, 0, 8, 63
"d:\TLProject\unity\Ongoing\Evolution\Assets\Scripts\MainMap.cs", "C#", 48, 0, 0, 0, 7, 55
"d:\TLProject\unity\Ongoing\Evolution\Assets\Scripts\RenderTextureUtils.cs", "C#", 15, 0, 0, 0, 1, 16
"d:\TLProject\unity\Ongoing\Evolution\Assets\Scripts\Shader\MainMap.shader", "ShaderLab", 0, 48, 0, 0, 6, 54
"d:\TLProject\unity\Ongoing\Evolution\Assets\Scripts\Shader\MapShader.shader", "ShaderLab", 0, 93, 0, 0, 14, 107
"d:\TLProject\unity\Ongoing\Evolution\Assets\Scripts\Shader\Temperature.shader", "ShaderLab", 0, 50, 0, 0, 6, 56
"d:\TLProject\unity\Ongoing\Evolution\Assets\Scripts\Species.cs", "C#", 30, 0, 0, 6, 7, 43
"d:\TLProject\unity\Ongoing\Evolution\Assets\Scripts\View\Displayer.cs", "C#", 39, 0, 0, 0, 7, 46
"Total", "-", 386, 191, 699, 46, 219, 1541